სცხელა	სცხელოდა	V;ARGSU3S;IPFV;MID;IND;IPFV
სწყურია	გვწყუროდა	V;ARGOB3;ARGSU1P;IPFV;MID;IND;IPFV
სჯერა	მჯერა	V;ARGSU1S;PRS;MID;IND;IPFV
ჰქვია	მქვია	V;ARGOB3;ARGSU1S;PRS;MID;IND;IPFV
აგდებს	ამოეგდო	V;ARGOB3;ARGSU3S;ACT;PST+PRF;PFV;IND
სცემს	მიეცათ	V;ARGOB3;ARGSU3P;PST+PRF;ACT;PFV;IND
ღრეცს	მოეღრიცოს	V;ARGOB3;ARGSU3S;ACT;PFV;SBJV
აჩენს	აღმოაჩენ	V;ARGOB3;ARGSU2S;FUT;ACT;PFV;IND
იცვამს	მოეცვა	V;ARGOB3;ARGSU3S;ACT;PST+PRF;PFV;IND
აწყობს	დაეწყო	V;ARGOB3;ARGSU3S;ACT;PST+PRF;PFV;IND
აბაშიძე	აბაშიძე	N;SG;OM;PROPN
აბიჯებს	მიაბიჯებდნენ	V;ARGSU3P;ACT;IPFV;PFV;IND
აბუჩი	აბუჩად	ADV
აგებს	განაგებს	V;ARGIO3;ARGOB3;ARGSU3S;FUT;ACT;PFV;IND
აგნებს	მიაგნებს	V;ARGIO3;ARGOB3;ARGSU3S;FUT;ACT;PFV;IND
აგრეთვე	აგრეთვე	ADV
აგროვებს	დააგროვეს	V;ARGOB3;ARGSU3P;PST;ACT;PFV;IND
ადამიანი	ადამიანი	N;NOM;ANIM;SG
ადამიანი	ადამიანის	N;GEN;ANIM;SG
ადამიანი	ადამიანთა	N;PL;GEN;INAN
ადამიანური	ადამიანური	ADJ;GEN;SG
ადგენს	წარმოადგენს	V;ARGOB3;ARGSU3S;FUT;ACT;PFV;IND
ადგია	წაადგებოდა	V;ARGOB3;ARGSU3S;PST+PRF;MID;PFV;IND
ადვოკატი	ადვოკატების	N;PL;GEN;INAN
აერთიანებს	გააერთიანებს	V;ARGOB3;ARGSU3S;FUT;ACT;PFV;IND
ავადმყოფი	ავადმყოფ	N;DAT;ANIM;SG
ავადმყოფობა	ავადმყოფობა	N;NOM;INAN;SG
ავთვისებიანი	ავთვისებიანი	ADJ;NOM;SG
ავიწყდება	დამავიწყდა	V;ARGOB3;ARGSU1S;PST;MID;PFV;IND
ავიწყდება	ავიწყდება	V;ARGOB3;ARGSU3S;PRS;MID;IND;IPFV
ავლებს	მოავლო	V;ARGIO3;ARGOB3;ARGSU2S;PST;ACT;PFV;IND
ავტობუსი	ავტობუსები	N;PL;OM;INAN;N
ავტორი	ავტორთა	N;PL;GEN;ANIM
ავტორი	ავტორ	N;DAT;ANIM;SG
აზრი	აზრი	N;NOM;INAN;SG
ათითებს	მიმეთითებინა	V;ARGOB3;ARGSU1S;ACT;PST+PRF;PFV;IND
აინტერესებს	გაინტერესებთ	V;ARGIO2;ARGOB3;ARGSU1;ACT;IPFV;PRS;IND
აინტერესებს	მაინტერესებს	V;ARGOB1S;ARGSU3S;ACT;PRS;IND;IPFV
აკადემია	აკადემია	N;DAT;INAN;SG
ალბათ	ალბათ	PART
ალექსანდრე	ალექსანდრე	PRO;SG;GEN;PN
ამავდროულად	ამავდროულად	ADV
ამბავი	ამბავ	N;DAT;INAN;SG
ამბობს	ამბობენ	V;ARGOB3;ARGSU3P;ACT;PRS;IND
ამბობს	ვამბობ	V;ARGOB3;ARGSU1S;ACT;PRS;IND
ამბულატორული	ამბულატორულ	ADJ;DAT;SG
ამდენად	ამდენად	ADV
ამდენი	ამდენს	PRO;DAT;SG
ამდენი	ამდენმა	PRO;ERG;SG
ამიტომ	ამიტომ	CONJ
ამომწურავი	ამომწურავი	ADJ;NOM;SG
ამოცანა	ამოცანა	N;NOM;INAN;SG
ამჟამად	ამჟამად	ADV
ამსახველი	ამსახველი	ADJ;NOM;SG
ამსგავსებს	მიამსგავსა	V;ARGIO3;ARGOB3;ARGSU3S;PST;ACT;PFV;IND
ამღერებული	ამღერებულ	V;DAT;PST;V.PTCP;IND;SG
ან	ან	CONJ
ანალიზი	ანალიზი	N;NOM;INAN;SG
ანგარიშგება	ანგარიშგების	N;GEN;INAN;SG
ანგარიში	ანგარიშის	N;GEN;INAN;SG
ანდა	ანდა	CONJ
ანდობს	გაგვანდო	V;ARGIO1P;ARGOB3;ARGSU3S;PST;ACT;PFV;IND
ანიჭებს	ანიჭებენ	V;ARGIO3;ARGOB3;ARGSU3P;ACT;PRS;IND;IPFV
ანიჭებს	ანიჭებს	V;ARGIO3;ARGOB3;ARGSU3S;ACT;PRS;IND;IPFV
ანკარა	ანკარა	ADJ;GEN;SG
ანუ	ანუ	CONJ
აპირობებს	განაპირობა	V;ARGOB3;ARGSU3S;PST;ACT;PFV;IND
აპრიალებს	აპრიალებდნენ	V;ARGOB3;ARGSU3P;IPFV;ACT;IND;IPFV
არ	არ	PART
არა	არა	PART
არადამაკმაყოფილებელი	არადამაკმაყოფილებელ	ADJ;DAT;SG
არადემოკრატიული	არადემოკრატიული	ADJ;NOM;SG
არაერთი	არაერთი	ADJ;GEN;SG
არავინ	არავინ	N;PRO;OM;SG
არამედ	არამედ	CONJ
არანაირი	არანაირი	ADJ;NOM;SG
არასაბიუჯეტო	არასაბიუჯეტო	ADJ;GEN;SG
არასამთავრობო	არასამთავრობო	ADJ;GEN;SG
არასასურველი	არასასურველ	ADJ;FRML;SG
არასერიოზული	არასერიოზულად	ADV
არაფერი	არაფერს	PRO;DAT;SG
არაფორმალური	არაფორმალური	ADJ;NOM;SG
არგუმენტი	არგუმენტებით	N;INS;PL;INAN
არგუმენტირებული	არგუმენტირებული	ADJ;NOM;SG
არე	არე	N;NOM;INAN;SG
არიდებს	განირიდებს	V;ARGOB3;ARGSU3S;FUT;ACT;PFV;IND
არის	ა	V;ARGSU2S;PRS;IND
არის	ვარ	V;ARGSU1S;PRS;IND
არის	არის	V;ARGSU3S;PRS;IND
არის	ხარ	V;ARGSU2S;PRS;IND
არის	იქნება	V;ARGSU3S;FUT;IND
არის	იყო	V;ARGSU3S;PST;IND
არმია	არმიის	N;GEN;INAN;SG
არსება	არსებებს	N;DAT;PL;ANIM
არსებობა	არსებობა	N;NOM;INAN;SG
არსებული	არსებული	ADJ;NOM;SG
არსებული	არსებულ	ADJ;DAT;SG
არჩევს	გამოარჩევდა	V;ARGOB3;ARGSU3S;FUT;ACT;PFV;IND
ასაგდები	ასაგდებად	ADV
ასაშენებელი	ასაშენებლად	ADJ;FRML;SG
ასე	ასე	ADV
ასევე	ასევე	ADV
ასიამოვნებს	ასიამოვნებს	V;ARGOB3;ARGSU3S;FUT;ACT;IND;IPFV
ასრულებს	ასრულებს	V;ARGIO3;ARGSU3S;ACT;PRS;IND;IPFV
ასრულებს	აღასრულებს	V;ARGOB3;ARGSU3S;FUT;ACT;PFV;IND
ასწორებს	ასწორებს	V;ARGIO3;ARGSU3S;ACT;PRS;IND;IPFV
ატირებს	წავიტირებ	V;ARGOB3;ARGSU1S;FUT;ACT;PFV;IND
აუცილებელი	აუცილებელი	ADJ;NOM;SG
აფარებს	აფარებს	V;ARGIO3;ARGOB3;ARGSU3S;ACT;PRS;IND;IPFV
აფართხალდება	აფართხალდა	V;ARGSU3S;PST;ACT;PFV;IND
აფასებს	აფასებს	V;ARGIO3;ARGSU3S;ACT;PRS;IND;IPFV
აფერმკრთალებს	გააფერმკრთალა	V;ARGOB3;ARGSU3S;PST;ACT;PFV;IND
აფიქრებინებს	გვაფიქრებინებს	V;ARGIO1P;ARGOB3;ARGSU3S;ACT;PRS;IND;IPFV
აქ	აქ	ADV
აქედან	აქედან	ADV
აქვს	მაქვს	V;ARGOB3;ARGSU1S;PRS;IND
აქვს	ჰქონდა	V;ARGOB3;ARGSU3S;IPFV;IND
აქვს	აქვს	V;ARGOB3;ARGSU3S;PRS;IND
აქვს	გაქვს	V;ARGOB3;ARGSU2S;PRS;IND
აქვს	გვქონდა	V;ARGOB3;ARGSU1P;IPFV;IND
აქტი	აქტებს	N;DAT;PL;INAN
აღიარებული	აღიარებული	ADJ;NOM;SG
აღნიშნავს	აღნიშნავდნენ	V;ARGOB3;ARGSU3P;IPFV;ACT;IND;IPFV
აღნიშნული	აღნიშნული	ADJ;GEN;SG
აღსავსე	აღსავსე	ADJ;NOM;SG
აღსანიშნავი	აღსანიშნავი	ADJ;NOM;SG
აღტაცება	აღტაცებით	N;INS;INAN;SG
აღძრული	აღძრული	ADJ;NOM;SG
აღჭურვილი	აღჭურვილი	ADJ;NOM;SG
აყენებს	იყენებენ	V;ARGOB3;ARGSU3P;ACT;PRS;IND;IPFV
აყენებს	გამოვიყენოთ	V;ARGOB3;ARGSU1P;PST;ACT;PFV;IND
აყვედრის	აყვედრიან	V;ARGOB3;ARGSU3P;ACT;PRS;IND;IPFV
აშკარა	აშკარა	ADJ;GEN;SG
აშურებს	მივაშურეთ	V;ARGSU1P;PST;ACT;PFV;IND
აცივდება	აცივდება	V;ARGSU3S;ACT;PRS;IND;IPFV
აცხადებს	გამოუცხადეს	V;ARGIO3;ARGOB3;ARGSU3P;PST;ACT;PFV;IND
აძლევს	აძლევდა	V;ARGOB3;ARGSU3S;ACT;IPFV;IND;IPFV
აძნელებს	გააძნელა	V;ARGOB3;ARGSU3S;PST;ACT;PFV;IND
ახალგაზრდა	ახალგაზრდა	ADJ;NOM;SG
ახალგაზრდა	ახალგაზრდებით	ADJ;INS;PL
ახალი	ახალი	ADJ;GEN;SG
ახალი	ახალ	ADJ;DAT;SG
ახალი	ახლად	ADJ;FRML;SG
ახვლედიანი	ახვლედიანის	PRO;SG;GEN;PN
ახლა	ახლა	ADV
ახლებური	ახლებურად	ADV
ახლოს	ახლოს	ADV
ახსენებს	ვახსენე	V;ARGIO3;ARGOB3;ARGSU1S;PST;ACT;IND;IPFV
ახსენებს	მოვახსენე	V;ARGIO3;ARGOB3;ARGSU1S;PST;ACT;PFV;IND
ახსოვს	ახსოვდა	V;ARGOB3;ARGSU3S;IPFV;MID;IND;IPFV
ბავშვი	ბავშვები	N;NOM;PL;ANIM
ბაზა	ბაზის	N;GEN;INAN;SG
ბაზარი	ბაზრის	N;GEN;INAN;SG
ბათუმი	ბათუმი	N;SG;OM;PROPN
ბათუმი	ბათუმის	PRO;SG;GEN;PN
ბალანსი	ბალანსის	N;GEN;INAN;SG
ბარგი	ბარგით	N;INS;INAN;SG
ბაქო-ბათუმი	ბაქო-ბათუმის	PRO;SG;GEN;PN
ბაღი	ბაღი	N;NOM;INAN;SG
ბგერა	ბგერები	N;PL;OM;INAN;N
ბექიშვილი	ბექიშვილს	PRO;DAT;SG;PN
ბეჭი	ბეჭ	N;DAT;INAN;SG
ბიუჯეტი	ბიუჯეტთა	N;DAT;PL;INAN
ბოთლი	ბოთლ	N;NOM;INAN;SG
ბოლო	ბოლო	ADJ;FRML;SG
ბოლოს	ბოლოს	ADV
ბოტანიკური	ბოტანიკური	ADJ;NOM;SG
ბრალდება	ბრალდებებს	N;DAT;PL;INAN
ბრალდება	ბრალდებებ	N;DAT;PL;INAN
ბრალდებული	ბრალდებულთა	N;PL;GEN;INAN
ბრძოლა	ბრძოლა	N;NOM;INAN;SG
ბრძოლა	ბრძოლის	N;GEN;INAN;SG
ბუნებრივი	ბუნებრივი	ADJ;NOM;SG
გადამწყვეტი	გადამწყვეტი	ADJ;NOM;SG
გადარჩენა	გადარჩენა	N;DAT;INAN;SG
გადასაწყვეტი	გადასაწყვეტი	V;NOM;PRS;V.PTCP;IND;SG
გადაუმოწმებელი	გადაუმოწმებელ	ADJ;DAT;SG
გადაქაჩვა	გადაქაჩვა	V;NOM;V.MSDR;PFV;SG
გადაწყვეტა	გადაწყვეტის	N;GEN;INAN;SG
გადგმული	გადგმული	ADJ;NOM;SG
გადის	გადის	V;ARGSU3S;PRS;IND
გავლენა	გავლენას	N;DAT;INAN;SG
გავრცელება	გავრცელებაც	N;NOM;INAN;SG
გათიშვა	გათიშვას	N;DAT;INAN;SG
გაივლის	გაუვლიდა	V;ARGOB3;ARGSU3S;FUT;IND
გამთბარი	გამთბარ	ADJ;DAT;SG
გამო	გამო	ADP;GEN
გამო	გამოც	ADP;GEN
გამომდინარე	გამომდინარე	ADJ;NOM;SG
გამომცემელი	გამომცემელი	N;NOM;ANIM;SG
გამოცდილება	გამოცდილება	N;NOM;INAN;SG
გამოცემა	გამოცემებ	N;DAT;PL;INAN
გამოცემული	გამოცემული	ADJ;GEN;SG
გამოცვლა	გამოცვლა	N;DAT;INAN;SG
გამოწერილი	გამოწერილი	ADJ;NOM;SG
გამოწვეული	გამოწვეული	ADJ;NOM;SG
გამტარიანობა	გამტარიანობის	N;GEN;INAN;SG
გამჭვირვალობა	გამჭვირვალობის	N;GEN;INAN;SG
გან	გან	ADP;GEN
განაგრძობს	განაგრძობენ	V;ARGOB3;ARGSU3P;FUT;ACT;PFV;IND
განვითარება	განვითარება	N;NOM;INAN;SG
განვითარება	განვითარების	N;GEN;INAN;SG
განმავითარებელი	განმავითარებელი	ADJ;NOM;SG
განმავლობა	განმავლობა	N;DAT;INAN;SG
განსაკუთრებული	განსაკუთრებული	ADJ;INS;SG
განსხეულება	განსხეულებას	N;DAT;INAN;SG
განსხვავება	განსხვავება	N;NOM;INAN;SG
განსხვავებული	განსხვავებულ	ADJ;DAT;SG
განცდილი	განცდილსა	ADJ;DAT;SG
განხორციელება	განხორციელებისას	N;DAT;INAN;SG
გარდა	გარდა	ADP;GEN
გარეგანი	გარეგანი	ADJ;NOM;SG
გარეთ	გარეთ	ADV
გარეშე	გარეშე	ADV
გარშემო	გარშემო	ADV
გარშემორტყმული	გარშემორტყმულ	ADJ;DAT;SG
გასათელი	გასათელად	ADV
გასაუბრალოებელი	გასაუბრალოებლად	ADV
გატარება	გატარებას	N;DAT;INAN;SG
გაუმჯობესება	გაუმჯობესების	N;GEN;INAN;SG
გაურკვევლობა	გაურკვევლობის	N;GEN;INAN;SG
გაცნობა	გაცნობა	N;NOM;INAN;SG
გებულობს	შემოგვაგებეს	V;ARGIO1P;ARGOB3;ARGSU3P;PST;ACT;PFV;IND
გეგმიანი	გეგმიანი	ADJ;GEN;SG
გერმანული	გერმანული	ADJ;GEN;SG
გვერდი	გვერდ	N;DAT;INAN;SG
გზა	გზებით	N;INS;PL;INAN
გზა	გზა	N;DAT;INAN;SG
გლეხი	გლეხები	N;NOM;PL;ANIM
გლეხი	გლეხის	N;GEN;ANIM;SG
გოგონი	გოგონები	N;NOM;PL;ANIM
გრამატიკული	გრამატიკული	ADJ;GEN;SG
გრგვინვა	გრგვინვა	N;NOM;INAN;SG
გრიალდება	შემოგრიალდა	V;ARGSU3S;PST;ACT;PFV;IND
გრიგოლ	გრიგოლ	N;SG;OM;PROPN
გრძნობა	გრძნობები	N;PL;OM;INAN;N
გრძნობს	ვგრძნობდით	V;ARGOB3;ARGSU1P;IPFV;ACT;IND;IPFV
გული	გულ	N;DAT;INAN;SG
გულისთქმა	გულისთქმა	N;NOM;INAN;SG
გულისხმობს	გულისხმობს	V;ARGOB3;ARGSU3S;ACT;PRS;IND;IPFV
გულმოდგინე	გულმოდგინედ	ADV
გუნდურობა	გუნდურობა	N;PL;OM;INAN;N
და	და	CONJ
დაავადება	დაავადებად	N;FRML;INAN;SG
დაავადება	დაავადების	N;GEN;INAN;SG
დაბადება	დაბადება	N;NOM;INAN;SG
დაბრუნება	დაბრუნების	N;GEN;INAN;SG
დაგეგმვა	დაგეგმვისა	N;GEN;INAN;SG
დადგენილი	დადგენილ	ADJ;DAT;SG
დადგენილი	დადგენილი	ADJ;GEN;SG
დადებითი	დადებითი	ADJ;NOM;SG
დადის	დადის	V;ARGSU3S;PRS;IND
დავითი	დავითი	N;SG;OM;PROPN
დაზუსტება	დაზუსტება	N;NOM;INAN;SG
დაინტერესებული	დაინტერესებული	ADJ;NOM;SG
დაკავშირებული	დაკავშირებულმა	ADJ;ERG;SG
დაკვირვება	დაკვირვების	N;GEN;INAN;SG
დამამკვიდრებელი	დამამკვიდრებლებმა	N;PL;ERG;ANIM
დამახასიათებელი	დამახასიათებელ	ADJ;DAT;SG
დამკვიდრება	დამკვიდრებისა	N;GEN;INAN;SG
დამოკიდებულება	დამოკიდებულებებ	N;DAT;PL;INAN
დამოკიდებული	დამოკიდებული	ADJ;NOM;SG
დამოუკიდებელი	დამოუკიდებელი	ADJ;NOM;SG
დამოუკიდებელი	დამოუკიდებელ	ADJ;DAT;SG
დამსახურება	დამსახურება	N;NOM;INAN;SG
დამტკიცება	დამტკიცების	N;GEN;INAN;SG
დამფრთხალი	დამფრთხალი	ADJ;NOM;SG
დამცავი	დამცავი	ADJ;INS;SG
დამცველი	დამცველი	N;NOM;ANIM;SG
დან	დან	INS;ADP
დაპირებული	დაპირებულს	ADJ;DAT;SG
დარბაზი	დარბაზის	N;GEN;INAN;SG
დარბაისლური	დარბაისლურად	ADV
დარგი	დარგები	N;PL;OM;INAN;N
დარწმუნებული	დარწმუნებული	ADJ;NOM;SG
დასაბუთებული	დასაბუთებული	ADJ;GEN;SG
დასავლეთი	დასავლეთ	ADJ;DAT;SG
დასაცავი	დასაცავად	ADV
დატვირთვა-გადმოტვირთვა	დატვირთვა-გადმოტვირთვის	N;GEN;INAN;SG
დატვირთული	დატვირთულ	ADJ;GEN;SG
დაუზუსტებელი	დაუზუსტებელი	V;V;GEN;.PTCP;SG
დაუნდობელი	დაუნდობელი	ADJ;NOM;SG
დაუსჯელი	დაუსჯელად	ADV
დაუყოვნებლივ	დაუყოვნებლივ	ADV
დაყენება	დაყენება	N;DAT;INAN;SG
დაყოფა	დაყოფას	N;DAT;INAN;SG
დაშტამპული	დაშტამპულ	ADJ;DAT;SG
დაცვა	დაცვა	N;NOM;INAN;SG
დაცვა	დაცვას	N;DAT;INAN;SG
დაძაბულობა	დაძაბულობას	N;DAT;INAN;SG
დაძაბულობა	დაძაბულობის	N;GEN;INAN;SG
დაწესებულება	დაწესებულების	N;GEN;INAN;SG
დაჭრილი	დაჭრილი	ADJ;NOM;SG
დახარჯვა	დახარჯვის	V;V;.MSDR;PFV;GEN;SG
დახატული	დახატული	ADJ;NOM;SG
დახმარება	დახმარებით	N;INS;INAN;SG
დახმარება	დახმარების	N;GEN;INAN;SG
დგას	იდგა	V;ARGSU3S;PST;ACT;IND;IPFV
დგას	დადგა	V;ARGSU3S;PST;ACT;PFV;IND
დგება	შეუდგნენ	V;ARGIO3;ARGSU3P;PST;ACT;PFV;IND
დემოგრაფიული	დემოგრაფიული	ADJ;NOM;SG
დემოკრატიული	დემოკრატიული	ADJ;GEN;SG
დიდი	დიდი	ADJ;INS;SG
დიდი	დიდად	ADV
დიდი	უდიდესი	N;RL;OM;ADJ;SG
დიდი	დიდ	ADJ;DAT;SG
დილა	დილას	ADV
დისციპლინა	დისციპლინების	N;PL;GEN;INAN
დნება	დნება	V;ARGSU3S;ACT;PRS;IND;IPFV
დონე	დონისა	N;GEN;INAN;SG
დოქი	დოქი	N;NOM;INAN;SG
დრო	დროსაც	N;DAT;INAN;SG
დრო	დროს	N;DAT;INAN;SG
დრტვინვა	დრტვინვას	N;DAT;INAN;SG
დღე	დღეს	N;DAT;INAN;SG
დღე	დღი	N;INS;INAN;SG
დღევანდელი	დღევანდელი	ADJ;GEN;SG
დღეიდან	დღეიდან	ADV
დღეს	დღესაც	ADV
ეალერსება	ეალერსებოდა	V;ARGIO3;ARGSU3S;ACT;IPFV;IND;IPFV
ედება	გამოედო	V;ARGIO3;ARGSU2S;PST;PASS;PFV;IND
ევროპა	ევროპა	PRO;DAT;SG;PN
ეზო	ეზო	N;DAT;INAN;SG
ეთხოვება	მითხოვია	V;ARGOB3S;ARGSU3;ACT;PFV;IND
ეკითხება	მეკითხება	V;ARGIO1S;ARGSU3S;ACT;PRS;IND;IPFV
ეკლესია	ეკლესიის	N;GEN;INAN;SG
ეკონომიკა	ეკონომიკას	N;DAT;INAN;SG
ემადლება	უმადლოდეს	V;ARGIO3;ARGSU3S;ACT;PRS;IND;IPFV
ემატება	აღემატება	V;ARGIO3;ARGSU3S;FUT;ACT;PFV;IND
ემგზავრება	გავემგზავრეთ	V;ARGIO3;ARGSU1P;PST;ACT;PFV;IND
ემზადება	ემზადებიან	V;ARGIO3;ARGSU3P;ACT;PRS;IND;IPFV
ენა	ენა	N;NOM;INAN;SG
ენა	ენით	N;INS;INAN;SG
ენა	ენის	N;GEN;INAN;SG
ენა	ენებ	N;DAT;PL;INAN
ენა	ენების	N;PL;GEN;INAN
ენერგია	ენერგია	N;NOM;INAN;SG
ეპიგონობა	ეპიგონობას	N;DAT;INAN;SG
ეპოქა	ეპოქას	N;DAT;INAN;SG
ერთად	ერთად	ADV
ერთერთი	ერთერთი	N;PRO;OM;SG
ერთ-ერთი	ერთ-ერთი	N;PRO;OM;SG
ერთი	ერთი	N;NOM;UM;SG
ერთი	ერთ	N;DAT;UM;SG
ერთი	პირველივე	N;NOM;UM;SG
ერთმანეთი	ერთმანეთს	PRO;DAT;SG
ერთობლიობა	ერთობლიობა	N;NOM;INAN;SG
ერთხელ	ერთხელ	ADV
ერი	ერს	N;DAT;ANIM;SG
ერი	ერის	N;GEN;ANIM;SG
ეროვნულ-გამათავისუფლებელი	ეროვნულ-გამათავისუფლებელი	ADJ;NOM;SG
ეროვნულ-გამათავისუფლებელი	ეროვნულ-გამათავისუფლებელ	ADJ;DAT;SG
ეროვნული	ეროვნულ	ADJ;DAT;SG
ეს	ამ	PRO;DAT;3;SG
ეს	ეს	PRO;NOM;3;SG
ეს(ე)	ამისა	PRO;3;GEN;SG
ეს(ე)	ამას	PRO;DAT;3;SG
ესკალაცია	ესკალაცია	N;NOM;INAN;SG
ესოდენ	ესოდენ	ADV
ეტანება	ეტანება	V;ARGIO3;ARGSU3S;PASS;PRS;IND;IPFV
ეუბნება	უთხრეს	V;ARGIO3;ARGOB3;ARGSU3P;PST;ACT;IND
ეუბნება	ეუბნება	V;ARGIO3;ARGOB3;ARGSU3S;ACT;PRS;IND
ეფექტიანი	ეფექტიანი	ADJ;GEN;SG
ექიმი	ექიმის	N;GEN;ANIM;SG
ექსპონირება	ექსპონირების	N;GEN;INAN;SG
ეყრდნობა	ეყრდნობოდნენ	V;ARGIO3;ARGSU3P;ACT;IPFV;IND;IPFV
ეჩქარება	მიეჩქარებოდათ	V;ARGOB3P;ARGSU3;IPFV;MID;IND;IPFV
ეცემა	ეცემა	V;ARGOB3;ARGSU3S;PRS;IND
ეძებს	ეძებენ	V;ARGOB3;ARGSU3P;ACT;PRS;IND;IPFV
ეწირება	ეწირება	V;ARGIO3;ARGSU3S;ACT;PRS;IND;IPFV
ეხება	ეხება	V;ARGIO3;ARGSU3S;ACT;PRS;IND;IPFV
ვ.	ვ.	N
ვაზი	ვაზს	N;DAT;INAN;SG
ვალიდური	ვალიდური	ADJ;NOM;SG
ვაჟა	ვაჟა	N;SG;OM;PROPN
ვაჭრობა	ვაჭრობის	N;GEN;INAN;SG
ველი	ველს	N;DAT;INAN;SG
ველი	ველის	N;GEN;INAN;SG
ვერც	ვერც	PART
ვეხი	ვეხის	PRO;SG;GEN;PN
ვით	ვით	NOM;ADP
ვინ	ვინმე	PRO;NOM;SG
ვინ	ვინც	PRO;NOM;SG
ვინ	ვის	PRO;GEN;SG
ზდოროვიე	ზდოროვიე	N;DAT;INAN;SG
ზე	ზე	DAT;ADP
ზე	ზეც	DAT;ADP
ზედაპირი	ზედაპირ	N;DAT;INAN;SG
ზედმეტი	ზედმეტად	ADV
ზევით	ზევით	ADV
ზემო	ზემოთ	ADJ;DAT;PL
ზემოთნახსენები	ზემოთნახსენებ	ADJ;DAT;SG
ზეპირი	ზეპირი	ADJ;NOM;SG
ზიდავს	გაზიდეს	V;ARGOB3;ARGSU3P;PST;ACT;PFV;IND
ზის	ისხდნენ	V;ARGSU3P;PST;ACT;IND
ზოგიერთი	ზოგიერთი	PRO;GEN;SG
ზოგჯერ	ზოგჯერ	ADV
ზონა	ზონებ	N;DAT;PL;INAN
ზრდა	ზრდა	N;NOM;INAN;SG
ზრდის	ზრდის	V;ARGOB3;ARGSU3S;ACT;PRS;IND;IPFV
ზუსტად	ზუსტად	ADV
თ.	თ.	N
თავადი	თავად	ADJ;NOM;SG
თავდადებული	თავდადებული	ADJ;NOM;SG
თავდაცვა	თავდაცვისა	N;GEN;INAN;SG
თავდება	თავდებოდა	V;ARGSU3S;ACT;IPFV;IND;IPFV
თავზარდამცემი	თავზარდამცემი	ADJ;NOM;SG
თავი	თავს	PRO;DAT;SG
თავი	თავ	PRO;DAT;SG
თავი	თავი	N;PRO;OM;SG
თავისებურება	თავისებურება	N;NOM;INAN;SG
თავისებური	თავისებურ	ADJ;DAT;SG
თავისთავად	თავისთავად	ADV
თავისი	თავის	PRO;DAT;SG
თავისი	თავისი	N;PRO;OM;SG
თავისუფლება	თავისუფლება	N;DAT;INAN;SG
თავმოყრილი	თავმოყრილი	ADJ;NOM;SG
თავშესაფარი	თავშესაფარს	N;DAT;INAN;SG
თან	თან	DAT;ADP
თან	თანაც	DAT;ADP
თანამებრძოლი	თანამებრძოლებით	N;INS;PL;ANIM
თანამედროვე	თანამედროვე	ADJ;GEN;SG
თანამშრომლობა	თანამშრომლობის	N;GEN;INAN;SG
თანამშრომლობა	თანამშრომლობა	N;NOM;INAN;SG
თანდათან	თანდათან	ADV
თანდათანობა	თანდათანობით	N;INS;INAN;SG
თანხლებით	თანხლებით	ADV
თანხმდება	შეთანხმდნენ	V;ARGSU3P;PST;ACT;PFV;IND
თარგმანება	თარგმანების	N;GEN;INAN;SG
თაღი	თაღის	N;GEN;INAN;SG
თბილი	თბილ	ADJ;DAT;SG
თეთრი	თეთრი	ADJ;NOM;SG
თემატიკა	თემატიკა	N;DAT;INAN;SG
თეორიული	თეორიულ	ADJ;DAT;SG
თვალი	თვალ	N;DAT;INAN;SG
თვალი	თვალის	N;GEN;INAN;SG
თვალი	თვალს	N;DAT;INAN;SG
თვალი	თვალი	N;NOM;INAN;SG
თვალსაზრისი	თვალსაზრისით	N;INS;INAN;SG
თვალსაჩინო	თვალსაჩინო	ADJ;NOM;SG
თვის	თვის	ADP;GEN
თვლემს	თვლემდნენ	V;ARGSU3P;ACT;IPFV;IND;IPFV
თითქოს	თითქოს	ADV
თოვლი	თოვლი	N;NOM;INAN;SG
თომა	თომა	N;SG;OM;PROPN
თუ	თუ	CONJ
თუმცა	თუმცა	CONJ
თურმე	თურმე	PART
თქვამს	გამოთქვამდნენ	V;ARGOB3;ARGSU3P;FUT;ACT;PFV;IND
თქვენ	თქვენ	PRO;DAT;PL;2
თქმა	თქმა	N;NOM;INAN;SG
თქო	ო	NFH;PART
თხოვს	მოითხოვდა	V;ARGOB3;ARGSU3S;FUT;ACT;PFV;IND
თხოვს	მოითხოვს	V;ARGOB3;ARGSU3S;FUT;ACT;PFV;IND
თხოულობს	თხოულობს	V;ARGOB3;ARGSU3S;ACT;PRS;IND;IPFV
ი/ეჩენილა	გაჩენილიყო	V;ARGSU3S;PST+PRF;PASS;PFV;IND
იბადება	დაიბადა	V;ARGSU3S;PST;PASS;PFV;IND
იბადება	იბადება	V;ARGSU3S;PASS;PRS;IND;IPFV
იგი	იგი	PRO;NOM;3;SG
იგი	მას	PRO;DAT;3;SG
იგი	მის	PRO;3;GEN;SG
იგი	მასაც	PRO;DAT;3;SG
იგი	მან	PRO;ERG;3;SG
იგი	იგივე	PRO;NOM;3;SG
იგინი	მათ	PRO;DAT;3;PL
ივსება	ავივსო	V;ARGSU1S;PST;PASS;PFV;IND
ითვლება	ითვლება	V;ARGSU3S;PASS;PRS;IND;IPFV
იკვეთება	იკვეთებოდა	V;ARGSU3S;IPFV;PASS;IND;IPFV
ილია	ილია	N;SG;OM;PROPN
იმავდროული	იმავდროულად	ADV
იმათი	იმათი	PRO;3;PL;GEN
იმართება	წარიმართოს	V;ARGSU3S;PST;PASS;PFV;IND
იმიტომ	იმიტომ	CONJ
ინდიკატორი	ინდიკატორებს	N;DAT;PL;INAN
ინიშნება	აღინიშნება	V;ARGSU3S;FUT;PASS;PFV;IND
ინიშნება	აღინიშნა	V;ARGSU3S;PST;PASS;PFV;IND
ინტერესი	ინტერესებისა	N;PL;GEN;INAN
ინტერესი	ინტერესს	N;DAT;INAN;SG
ინფორმაცია	ინფორმაციამ	N;ERG;INAN;SG
ინფორმაცია	ინფორმაციების	N;PL;GEN;INAN
ინფორმაცია	ინფორმაციას	N;DAT;INAN;SG
იპყრობს	იპყრობდნენ	V;ARGOB3;ARGSU3P;IPFV;ACT;IND;IPFV
ირჩევა	გამოირჩა	V;ARGSU3S;PST;ACT;PFV;IND
ირჩევს	აირჩიეს	V;ARGOB3;ARGSU3P;PST;ACT;PFV;IND
ის	იმისა	PRO;3;GEN;SG
ის	იმის	PRO;3;GEN;SG
ის	იმ	PRO;3;GEN;SG
ის	იმით	PRO;INS;3;SG
ის	იმავე	PRO;DAT;3;SG
ის(ი)	ის	PRO;NOM;3;SG
ის(ი)	იმა	PRO;DAT;3;SG
ის(ი)	იმას	PRO;DAT;3;SG
ისე	ისე	ADV
ისინი	ისინი	PRO;NOM;3;PL
ისტორია	ისტორია	N;NOM;INAN;SG
იტანს	მოიტანა	V;ARGOB3;ARGSU3S;PST;IND
იქ	იქვე	ADV
იქ	იქ	ADV
იქმნება	შეიქმნას	V;ARGSU3S;PST;PASS;PFV;IND
იქცევა	იქცა	V;ARGSU3S;PST;ACT;IND;IPFV
იღვრება	იღვრება	V;ARGSU3S;PASS;PRS;IND;IPFV
იყენებს	გამოიყენება	V;ARGSU3S;ACT;PRS;IND;IPFV
იყვანს	მოვიყვან	V;ARGOB3;ARGSU1S;FUT;ACT;PFV;IND
იყვანს	მიგვიყვანოს	V;ARGIO1P;ARGOB3;ARGSU3S;PST;ACT;PFV;IND
იჩნევს	მიიჩნევდა	V;ARGOB3;ARGSU3S;FUT;ACT;PFV;IND
იცვამს	იცვამს	V;ARGOB3;ARGSU3S;ACT;PRS;IND;IPFV
იცის	იციან	V;ARGOB3;ARGSU3P;ACT;PRS;IND
იძახის	იძახის	V;ARGOB3;ARGSU3S;ACT;PRS;IND;IPFV
იძახის	მეძახიან	V;ARGIO1S;ARGSU3P;ACT;PRS;IND;IPFV
იძენს	იძენს	V;ARGOB3;ARGSU3S;ACT;PRS;IND;IPFV
იძირება	იძირებიან	V;ARGSU3P;ACT;PRS;IND;IPFV
იძლევა	იძლევა	V;ARGSU3S;ACT;PRS;IND;IPFV
იწვევს	იწვევს	V;ARGOB3;ARGSU3S;ACT;PRS;IND;IPFV
იწყება	იწყება	V;ARGSU3S;ACT;PRS;IND;IPFV
იწყობს	დაიწყო	V;ARGOB3;ARGSU2S;PST;ACT;PFV;IND
იჭყიტება	იჭყიტება	V;ARGSU3S;ACT;PRS;IND;IPFV
კაბინეტი	კაბინეტს	N;DAT;INAN;SG
კაბინეტი	კაბინეტის	N;GEN;INAN;SG
კავკასია	კავკასია	PRO;DAT;SG;PN
კავკასია	კავკასიის	N;GEN;INAN;SG
კავკასიური	კავკასიური	ADJ;GEN;SG
კალიასკა	კალიასკა	N;NOM;INAN;SG
კამათობს	კამათობენ	V;ARGSU3P;ACT;PRS;IND;IPFV
კანონი	კანონის	N;GEN;INAN;SG
კარგი	კარგი	ADJ;NOM;SG
კარგი	საუკეთესო	ADJ;FRML;RL;SG
კარდინალური	კარდინალური	ADJ;GEN;SG
კაცი	კაცი	N;NOM;ANIM;SG
კედელი	კედლებ	N;DAT;PL;INAN
კეთდება	კეთდება	V;ARGSU3S;ACT;PRS;IND;IPFV
კეთილი	კეთილი	ADJ;NOM;SG
კენ	კენ	ADP;GEN
კერძო	კერძო	ADJ;DAT;SG
კვირა	კვირა	N;DAT;INAN;SG
კვირადღე	კვირადღის	N;GEN;INAN;SG
კვლავ	კვლავ	ADV
კვლევა	კვლევის	N;GEN;INAN;SG
კვლევა-ძიება	კვლევა-ძიებას	N;DAT;INAN;SG
კი	კი	PART
კიდევ	კიდევ	ADV
კითხვა	კითხვები	N;PL;OM;INAN;N
კილო	კილო	N;DAT;INAN;SG
კილომეტრი	კმ-ი	N;NOM;SG
კისერი	კისრის	N;GEN;INAN;SG
კისერი	კისერი	N;NOM;INAN;SG
კლასიკური	კლასიკურ	ADJ;FRML;SG
კლდე	კლდის	N;GEN;INAN;SG
კლება	კლებას	N;DAT;INAN;SG
კლიმატური	კლიმატური	ADJ;INS;SG
კმარობს	კმაროდა	V;ARGSU3S;ACT;IPFV;IND;IPFV
კომენტარი	კომენტარები	N;PL;OM;INAN;N
კომპლექსი	კომპლექსის	N;GEN;INAN;SG
კომპლექსური	კომპლექსურ	ADJ;DAT;SG
კონკრეტული	კონკრეტულ	ADJ;DAT;SG
კონკრეტული	კონკრეტული	ADJ;NOM;SG
კონკურენტი	კონკურენტების	N;PL;GEN;ANIM
კონფლიქტი	კონფლიქტების	N;PL;GEN;INAN
კონფლიქტური	კონფლიქტურ	ADJ;DAT;SG
კონფლიქტურობა	კონფლიქტურობისა	N;GEN;INAN;SG
კონცეფცია	კონცეფცია	N;NOM;INAN;SG
კოპტური	კოპტურ	ADJ;DAT;SG
კორუმპირებულ-კრიმინალური	კორუმპირებულ-კრიმინალური	ADJ;GEN;SG
კოსმოსური	კოსმოსურ	ADJ;DAT;SG
კოხტა	კოხტა	ADJ;NOM;SG
კრებული	კრებულ	N;DAT;INAN;SG
კრიტიკა	კრიტიკა	N;NOM;INAN;SG
კრიტიკა	კრიტიკის	N;GEN;INAN;SG
კრიტიკა	კრიტიკას	N;DAT;INAN;SG
კუთხე	კუთხე	N;DAT;INAN;SG
კულტურა	კულტურის	N;GEN;INAN;SG
კულტუროსანი	კულტუროსან	ADJ;DAT;SG
კურორტი	კურორტად	N;FRML;INAN;SG
ლაგდება	ლაგდებიან	V;ARGSU3P;ACT;PRS;IND;IPFV
ლაზათიანი	ლაზათიანი	ADJ;NOM;SG
ლაზარეთი	ლაზარეთი	N;INS;INAN;SG
ლამაზი	ლამაზი	ADJ;NOM;SG
ლამაზი	ლამაზთა	ADJ;PL;GEN
ლაპარაკობს	ვლაპარაკობ	V;ARGSU1S;ACT;PRS;IND;IPFV
ლაშქრობა	ლაშქრობა	N;DAT;INAN;SG
ლეგიტიმური	ლეგიტიმური	ADJ;NOM;SG
ლევანი	ლევანი	N;SG;OM;PROPN
ლექსი	ლექსის	N;GEN;INAN;SG
ლექსი	ლექსი	N;INS;INAN;SG
ლექსი	ლექსების	N;PL;GEN;INAN
ლიტერატურა	ლიტერატურის	N;GEN;INAN;SG
მაგალითი	მაგალითად	N;FRML;INAN;SG
მაგვარი	მაგვარ	ADJ;DAT;SG
მაგისტრალური	მაგისტრალური	ADJ;NOM;SG
მაგრამ	მაგრამ	CONJ
მაინც	მაინც	PART
მაისი	მაისის	N;GEN;INAN;SG
მალა	მალების	N;PL;GEN;INAN
მამული	მამულ	N;DAT;INAN;SG
მანამდე	მანამდე	ADV
მანქანა	მანქანები	N;PL;OM;INAN;N
მართებლობა	მართებლობის	N;GEN;INAN;SG
მართვა	მართვა	N;DAT;INAN;SG
მართვა	მართვის	N;GEN;INAN;SG
მარტო	მარტო	ADV
მასშტაბური	მასშტაბური	ADJ;GEN;SG
მასწავლებელი	მასწავლებელი	N;NOM;ANIM;SG
მატერიალური	მატერიალურ	ADJ;GEN;SG
მატერიალური	მატერიალური	ADJ;GEN;SG
მატერიალურ-ტექნიკური	მატერიალურ-ტექნიკური	ADJ;GEN;SG
მაქსიმალური	მაქსიმალური	ADJ;NOM;SG
მაღალი	უმაღლესი	ADJ;RL;GEN;SG
მაღალი	უმაღლეს	ADJ;DAT;RL;SG
მაღალკვალიფიციური	მაღალკვალიფიციური	ADJ;NOM;SG
მაღალფარდოვანი	მაღალფარდოვან	ADJ;DAT;SG
მაღლდება	ამაღლდა	V;ARGSU3S;PST;ACT;PFV;IND
მაშინ	მაშინაც	ADV
მაჩვენებელი	მაჩვენებლის	N;GEN;INAN;SG
მაძიებელი	მაძიებელი	N;NOM;ANIM;SG
მახასიათებელი	მახასიათებელი	ADJ;NOM;SG
მდე	მდე	ADP;FRML
მე	მე	PRO;NOM;1;SG
მე	მეც	PRO;NOM;1;SG
მე	ჩემ	PRO;1;GEN;SG
მეგობარი	მეგობრები	N;NOM;PL;ANIM
მეგობრობა	მეგობრობა	N;NOM;INAN;SG
მეგობრობა	მეგობრობის	N;GEN;INAN;SG
მეგობრული	მეგობრული	ADJ;INS;SG
მეზობელი	მეზობელი	N;NOM;ANIM;SG
მეზობელ-ნათესავი	მეზობელ-ნათესავები	N;NOM;PL;ANIM
მეთოდი	მეთოდების	N;PL;GEN;INAN
მელექსე	მელექსეთა	N;DAT;PL;ANIM
მეტი	მეტად	ADV
მეტი	მეტი	ADJ;NOM;SG
მეტ-ნაკლებად	მეტ-ნაკლებად	ADV
მეურნეობა	მეურნეობა	N;NOM;INAN;SG
მეურნეობა	მეურნეობის	N;GEN;INAN;SG
მეურნეობრივი	მეურნეობრივი	ADJ;GEN;SG
მეფე	მეფე	N;NOM;ANIM;SG
მეფე	მეფეთა	N;PL;GEN;ANIM
მეფე	მეფის	N;GEN;ANIM;SG
მექანიზებული	მექანიზებული	ADJ;INS;SG
მეცნიერი	მეცნიერები	N;NOM;PL;ANIM
მეცნიერული	მეცნიერულად	ADJ;FRML;SG
მეწინავე	მეწინავე	ADJ;DAT;SG
მზარდი	მზარდ	ADJ;DAT;SG
მზე	მზის	N;GEN;INAN;SG
მზე	მზით	N;INS;INAN;SG
მთა	მთის	N;GEN;INAN;SG
მთა	მთათა	N;PL;GEN;INAN
მთა	მთებით	N;INS;PL;INAN
მთავარი	მთავარი	ADJ;NOM;SG
მთავარი	უმთავრესად	ADJ;FRML;RL;SG
მთავრობა	მთავრობის	N;GEN;INAN;SG
მთავრობა	მთავრობების	N;PL;GEN;INAN
მთარგმნელი	მთარგმნელის	N;GEN;ANIM;SG
მთარგმნელი	მთარგმნელსაც	N;DAT;ANIM;SG
მთელი	მთელი	ADJ;NOM;SG
მთელი	მთელ	ADJ;DAT;SG
მთვარე	მთვარე	N;NOM;INAN;SG
მთლიანი	მთლიანი	ADJ;NOM;SG
მიაქვს	მიქონდათ	V;ARGOB3;ARGSU3P;IPFV;IND
მიბრუნებული	მიბრუნებულად	ADV
მიდის	მიდიოდნენ	V;ARGSU3P;IPFV;IND
მიზანი	მიზნის	N;GEN;INAN;SG
მიზანი	მიზნით	N;INS;INAN;SG
მიზანი	მიზან	N;DAT;INAN;SG
მიზანი	მიზნად	N;FRML;INAN;SG
მიი/ეფინება	მიჰფენოდნენ	V;ARGOB3;ARGSU3P;ACT;PFV;SBJV
მილსადენი	მილსადენი	N;NOM;INAN;SG
მიმოქცევა	მიმოქცევის	N;GEN;INAN;SG
მიმოხილვა	მიმოხილვისა	N;GEN;INAN;SG
მინისტრი	მინისტრი	N;NOM;ANIM;SG
მინისტრი	მინისტრის	N;GEN;ANIM;SG
მისაყენებელი	მისაყენებლად	ADV
მისაჩქმალავი	მისაჩქმალავად	ADV
მისი	მისი	PRO;NOM;3;SG
მიუხედავად	მიუხედავად	ADV
მიქცეული	მიქცეული	ADJ;NOM;SG
მიწა	მიწას	N;DAT;INAN;SG
მიხედვით	მიხედვით	ADV
მკითხველი	მკითხველი	N;NOM;ANIM;SG
მკითხველი	მკითხველს	N;DAT;ANIM;SG
მნახველი	მნახველს	N;DAT;ANIM;SG
მნიშვნელობა	მნიშვნელობას	N;DAT;INAN;SG
მნიშვნელობა	მნიშვნელობა	N;NOM;INAN;SG
მნიშვნელოვანი	მნიშვნელოვანი	ADJ;NOM;SG
მნიშვნელოვანი	მნიშვნელოვან	ADJ;DAT;SG
მნიშვნელოვანწილად	მნიშვნელოვანწილად	ADV
მოდის	მოდიან	V;ARGSU3P;PRS;IND
მოდის	მოდის	V;ARGSU3S;PRS;IND
მოდის	მოვა	V;ARGSU3S;FUT;IND
მოდის	მოსულა	V;ARGSU2S;IND
მოთხოვნა	მოთხოვნით	N;INS;INAN;SG
მოკლე	მოკლე	ADJ;NOM;SG
მომავალი	მომავალ	N;DAT;INAN;SG
მომავალი	მომავლის	N;GEN;INAN;SG
მონათლული	მონათლული	V;NOM;PST;V.PTCP;IND;SG
მონაწილე	მონაწილე	N;NOM;ANIM;SG
მონაწილეობა	მონაწილეობასა	N;DAT;INAN;SG
მონაწილეობს	მონაწილეობდეს	V;ARGSU3S;ACT;PRS;IND;IPFV
მონიტორინგი	მონიტორინგისა	N;GEN;INAN;SG
მოსაზრება	მოსაზრებებ	N;DAT;PL;INAN
მოსახლეობა	მოსახლეობისა	N;GEN;INAN;SG
მოსახლეობა	მოსახლეობის	N;GEN;INAN;SG
მოსწავლე	მოსწავლის	N;GEN;ANIM;SG
მოსწავლე	მოსწავლეებმა	N;PL;ERG;ANIM
მოსწავლე	მოსწავლეები	N;NOM;PL;ANIM
მოსწავლე	მოსწავლეებს	N;DAT;PL;ANIM
მოულოდნელობა	მოულოდნელობებითა	N;INS;PL;INAN
მოღვაწეობა	მოღვაწეობის	N;GEN;INAN;SG
მოძრაობა	მოძრაობა	N;NOM;INAN;SG
მოწადინე	მოწადინე	ADJ;NOM;SG
მოხელე	მოხელის	N;GEN;ANIM;SG
მოხუცი	მოხუცი	ADJ;NOM;SG
მრავალი	მრავალი	ADJ;NOM;SG
მრავალმხრივი	მრავალმხრივი	ADJ;NOM;SG
მრავალრიცხოვანი	მრავალრიცხოვან	ADJ;DAT;SG
მრავალფეროვნება	მრავალფეროვნება	N;NOM;INAN;SG
მსჯელობს	მსჯელობენ	V;ARGSU3P;ACT;PRS;IND;IPFV
მტრედი	მტრედი	N;NOM;ANIM;SG
მუდამ	მუდამ	ADV
მუშაობა	მუშაობის	N;GEN;INAN;SG
მუშაობა	მუშაობა	N;NOM;INAN;SG
მფლობელი	მფლობელებს	N;DAT;PL;ANIM
მშვიდობა	მშვიდობის	N;GEN;INAN;SG
მშობლიური	მშობლიურ	ADJ;GEN;SG
მცდელობა	მცდელობები	N;PL;OM;INAN;N
მცდელობა	მცდელობებს	N;DAT;PL;INAN
მცირე	მცირე	ADJ;GEN;SG
მცირეოდენი	მცირეოდენ	ADJ;DAT;SG
მცოდნე	მცოდნენი	N;NOM;PL;ANIM
მცხეთა	მცხეთის	PRO;SG;GEN;PN
მძაფრი	მძაფრი	ADJ;GEN;SG
მძიმე	მძიმე	ADJ;DAT;SG
მძლავრი	მძლავრი	ADJ;INS;SG
მძღოლი	მძღოლმა	N;ERG;ANIM;SG
მწერალი	მწერალი	N;NOM;ANIM;SG
მწერლობა	მწერლობის	N;GEN;INAN;SG
მწვავე	მწვავე	ADJ;NOM;SG
მხარე	მხარე	N;NOM;INAN;SG
მხარე	მხარეს	N;DAT;INAN;SG
მხარე	მხარეები	N;PL;OM;INAN;N
მხარე	მხარეებს	N;DAT;PL;INAN
მხარი	მხარ	N;DAT;INAN;SG
მხარი	მხრი	N;INS;INAN;SG
მხოლოდ	მხოლოდ	ADV
ნაგებობა	ნაგებობები	N;INS;PL;INAN
ნადირი	ნადირიც	N;NOM;ANIM;SG
ნავთობი	ნავთობის	N;GEN;INAN;SG
ნავთობსადენი	ნავთობსადენი	N;NOM;INAN;SG
ნავთობსადენი	ნავთობსადენის	N;GEN;INAN;SG
ნავსადგური	ნავსადგურები	N;PL;OM;INAN;N
ნავსადგური	ნავსადგურების	N;PL;GEN;INAN
ნათქვამი	ნათქვამის	N;GEN;INAN;SG
ნათქვამი	ნათქვამი	N;NOM;INAN;SG
ნაკლები	ნაკლებად	ADV
ნაკლებობა	ნაკლებობა	N;NOM;INAN;SG
ნამდვილი	ნამდვილ	ADJ;FRML;SG
ნამუშევარი	ნამუშევრების	N;PL;GEN;INAN
ნანახი	ნანახს	ADJ;DAT;SG
ნაშრომი	ნაშრომი	N;NOM;INAN;SG
ნაშრომი	ნაშრომებსაც	N;DAT;PL;INAN
ნაშრომი	ნაშრომებს	N;DAT;PL;INAN
ნაწარმი	ნაწარმს	N;DAT;INAN;SG
ნაწილი	ნაწილის	N;GEN;INAN;SG
ნახავს	დავინახე	V;ARGOB3;ARGSU1S;PST;ACT;PFV;IND
ნახავს	ვნახე	V;ARGOB3;ARGSU1S;PST;ACT;IND;IPFV
ნახავს	ნახა	V;ARGOB3;ARGSU3S;PST;ACT;IND;IPFV
ნახავს	ვნახეთ	V;ARGOB3;ARGSU1P;PST;ACT;IND;IPFV
ნახევარი	ნახევარ	ADJ;DAT;SG
ნება	ნების	N;GEN;INAN;SG
ნება-სურვილი	ნება-სურვილის	N;GEN;INAN;SG
ნეოლითი	ნეოლითის	N;GEN;INAN;SG
ნერვი	ნერვებს	N;DAT;PL;INAN
ნივთავს	შეუნივთა	V;ARGIO3;ARGOB3;ARGSU3S;PST;ACT;PFV;IND
ნიმუში	ნიმუში	N;NOM;INAN;SG
ნიშნავს	ნიშნავს	V;ARGOB3;ARGSU3S;ACT;PRS;IND;IPFV
ობიექტური	ობიექტური	ADJ;NOM;SG
ოდისეა	ოდისეა	PRO;DAT;SG;PN
ოთახი	ოთახ	N;DAT;INAN;SG
ოპოზიცია	ოპოზიცია	N;NOM;INAN;SG
ორგანიზაცია	ორგანიზაციას	N;DAT;INAN;SG
ორგანიზაცია	ორგანიზაციები	N;PL;OM;INAN;N
ორგანო	ორგანოების	N;PL;GEN;INAN
ორდინარული	ორდინარულ	ADJ;DAT;SG
ორი	მეორე	N;NOM;UM;SG
ორი	ორ	N;DAT;UM;SG
ორი	ორი	N;INS;UM;SG
ოსტეოქონდროზი	ოსტეოქონდროზი	N;NOM;INAN;SG
ოღონდ	ოღონდ	CONJ
ოცნება	ოცნება	N;DAT;INAN;SG
პარაგრაფი	პარაგრაფ	N;DAT;INAN;SG
პარაკლისი	პარაკლისი	N;NOM;INAN;SG
პასუხი	პასუხების	N;PL;GEN;INAN
პასუხი	პასუხი	N;NOM;INAN;SG
პასუხისმგებლობა	პასუხისმგებლობის	N;GEN;INAN;SG
პატარა	პატარა	ADJ;INS;SG
პატივისცემა	პატივისცემით	N;INS;INAN;SG
პერიოდი	პერიოდა	N;FRML;INAN;SG
პირადი	პირად	ADJ;DAT;SG
პირი	პირის	N;GEN;INAN;SG
პირი	პირების	N;PL;GEN;INAN
პირი	პირებისა	N;PL;GEN;INAN
პირიქით	პირიქით	ADV
პირობა	პირობებ	N;DAT;PL;INAN
პირობა	პირობებით	N;INS;PL;INAN
პიროვნული	პიროვნულ	ADJ;DAT;SG
პლაჟი	პლაჟით	N;INS;INAN;SG
პოეტი	პოეტის	N;GEN;ANIM;SG
პოეტური	პოეტური	ADJ;NOM;SG
პოლიტიკა	პოლიტიკის	N;GEN;INAN;SG
პოლიტიკური	პოლიტიკური	ADJ;NOM;SG
პრინციპი	პრინციპების	N;PL;GEN;INAN
პრობლემა	პრობლემები	N;PL;OM;INAN;N
პრობლემა	პრობლემას	N;DAT;INAN;SG
პრობლემური	პრობლემური	ADJ;NOM;SG
პროგრამა	პროგრამებ	N;DAT;PL;INAN
პროკურატურა	პროკურატურა	N;DAT;INAN;SG
პროფესორი	პროფესორი	N;NOM;ANIM;SG
პროფესორი	პროფ	N
პროცესი	პროცესების	N;PL;GEN;INAN
პროცესი	პროცესის	N;GEN;INAN;SG
პროცესი	პროცეს	N;DAT;INAN;SG
ჟესტი	ჟესტიც	N;NOM;INAN;SG
ჟურნალი	ჟურნალ	N;NOM;INAN;SG
ჟღერადობა	ჟღერადობას	N;DAT;INAN;SG
რა	რამ	PRO;ERG;SG
რა	რაღაც	N;PRO;OM;SG
რა	რას	PRO;DAT;SG
რა	რა	PRO;DAT;SG
რა	რის	PRO;GEN;SG
რადგან	რადგან	CONJ
რაზეც	რაზეც	CONJ
რამაც	რამაც	PRO;ERG;SG
რამდენი	რამდენი	N;PRO;OM;SG
რამდენიმე	რამდენიმე	PRO;DAT;SG
რამოდენიმე	რამოდენიმე	N;PRO;OM;SG
რატომ	რატომღაც	ADV
რაშიც	რაშიც	CONJ
რაც	რაც	CONJ
რეაგირება	რეაგირების	N;GEN;INAN;SG
რევოლუცია	რევოლუციის	N;GEN;INAN;SG
რევოლუცია	რევოლუცია	N;FRML;INAN;SG
რევოლუციური	რევოლუციური	ADJ;GEN;SG
რეკომენდაცია	რეკომენდაციების	N;PL;GEN;INAN
რეკომენდაცია	რეკომენდაციებს	N;DAT;PL;INAN
რეკონსტრუქცია	რეკონსტრუქციისა	N;GEN;INAN;SG
რეპრესიული	რეპრესიულად	ADV
რესპუბლიკა	რესპუბლიკის	N;GEN;INAN;SG
რესურსი	რესურსების	N;PL;GEN;INAN
რეფორმირება	რეფორმირებისას	N;DAT;INAN;SG
რეფორმირებული	რეფორმირებული	ADJ;NOM;SG
რთული	რთული	ADJ;INS;SG
რიგი	რიგ	N;NOM;INAN;SG
რკინა	რკინის	N;GEN;INAN;SG
როგორ	როგორ	CONJ
როგორ	როგორც	CONJ
როდესაც	როდესაც	CONJ
როლი	როლს	N;DAT;INAN;SG
რომ	რომ	CONJ
რომანი	რომანი	N;NOM;INAN;SG
რომელი	რომელნიც	PRO;NOM;PL
რომელი	რომელსაც	PRO;DAT;SG
რომელი	რომელიც	N;PRO;OM;SG
რომელი	რომლითაც	PRO;INS;SG
რომელი	რომელთა	PRO;PL;GEN
რომლებიც	რომლებიც	N;PRO;OM;PL
როცა	როცა	CONJ
რუსეთი	რუსეთის	PRO;SG;GEN;PN
საათი	საათებ	N;DAT;PL;INAN
საგანგაშო	საგანგაშო	ADJ;NOM;SG
საგანგებო	საგანგებო	ADJ;GEN;SG
საგზაო	საგზაო	ADJ;NOM;SG
სად	სად	ADV
სადაც	სადაც	ADV
სადღაც	სადღაც	ADV
საერთაშორისო	საერთაშორისო	ADJ;GEN;SG
საერთო	საერთო	ADJ;DAT;SG
საერთოდ	საერთოდ	ADV
სავსე	სავსე	ADJ;NOM;SG
სავსებით	სავსებით	ADV
საზოგადოება	საზოგადოების	N;GEN;ANIM;SG
საზომი	საზომები	N;PL;OM;INAN;N
საზღვაო	საზღვაო	ADJ;FRML;SG
საზღვარგარეთ	საზღვარგარეთ	ADV
სათავე	სათავეებ	N;DAT;PL;INAN
სათქმელი	სათქმელის	N;GEN;INAN;SG
საიდუმლო	საიდუმლოდ	ADV
საიდუმლოება	საიდუმლოება	N;NOM;INAN;SG
საილუსტრაციო	საილუსტრაციოდ	ADV
საინტერესო	საინტერესო	ADJ;ERG;SG
საკითხი	საკითხებ	N;DAT;PL;INAN
საკითხი	საკითხების	N;PL;GEN;INAN
საკითხი	საკითხის	N;GEN;INAN;SG
საკითხი	საკითხი	N;NOM;INAN;SG
საკმაოდ	საკმაოდ	ADV
საკუთარი	საკუთარი	ADJ;GEN;SG
საკუთარი	საკუთარ	ADJ;DAT;SG
საკუთრება	საკუთრებას	N;DAT;INAN;SG
სამართალდამცავი	სამართალდამცავი	N;NOM;ANIM;SG
სამართალდაცვა	სამართალდაცვის	N;GEN;INAN;SG
სამართლებრივი	სამართლებრივი	ADJ;GEN;SG
სამართლიანი	სამართლიანად	ADV
სამედიცინო	სამედიცინო	ADJ;DAT;SG
სამეცნიერო-კვლევითი	სამეცნიერო-კვლევითი	ADJ;NOM;SG
სამი	სამი	N;NOM;UM;SG
სამკვიდრო	სამკვიდროს	N;DAT;INAN;SG
სამომავლო	სამომავლოდ	ADV
სამოსელი	სამოსელს	N;DAT;INAN;SG
სამოქალაქო	სამოქალაქო	ADJ;GEN;SG
სამსახური	სამსახურ	N;DAT;INAN;SG
სამუშაო	სამუშაოები	N;PL;OM;INAN;N
სამყარო	სამყარო	N;DAT;INAN;SG
სამყარო	სამყაროს	N;GEN;INAN;SG
სამშობლო	სამშობლოდ	N;FRML;INAN;SG
სამწუხარო	სამწუხაროდ	ADV
სამხედრო	სამხედრო	ADJ;DAT;SG
სანავსადგურო	სანავსადგურო	ADJ;GEN;SG
სანამ	სანამ	CONJ
სანახევრო	სანახევროდ	ADV
სანდოობა	სანდოობა	N;NOM;INAN;SG
საოცარი	საოცარ	ADJ;DAT;SG
სარგებლობა	სარგებლობა	N;NOM;INAN;SG
სარისკო	სარისკო	ADJ;NOM;SG
სასამართლო	სასამართლო	N;NOM;INAN;SG
სასეირო	სასეირო	ADJ;DAT;SG
სასიცოცხლო	სასიცოცხლო	ADJ;GEN;SG
სასწავლებელი	სასწავლებლებისა	N;PL;GEN;INAN
სასწავლებელი	სასწავლებლებ	N;DAT;PL;INAN
სასწაული	სასწაულს	N;DAT;INAN;SG
სატვირთო	სატვირთო	ADJ;NOM;SG
საუბარი	საუბარი	N;NOM;INAN;SG
საუცხოო	საუცხოო	ADJ;INS;SG
საფუძველი	საფუძველი	N;NOM;INAN;SG
საფუძველი	საფუძველ	N;DAT;INAN;SG
საქართველო	საქართველოს	PRO;SG;GEN;PN
საქართველო	საქართველო	PRO;DAT;SG;PN
საქმე	საქმე	N;NOM;INAN;SG
საქმე	საქმეებსა	N;DAT;PL;INAN
საქმიანობა	საქმიანობის	N;GEN;INAN;SG
საყდარი	საყდარი	N;NOM;INAN;SG
საყოველთაო	საყოველთაოდ	ADV
საყურადღებო	საყურადღებო	ADJ;DAT;SG
საშინელება	საშინელება	N;DAT;INAN;SG
საშინელი	საშინლად	ADJ;FRML;SG
საშიში	საშიშ	ADJ;FRML;SG
საშუალება	საშუალებას	N;DAT;INAN;SG
საშუალო	საშუალო	ADJ;GEN;SG
საჩივარი	საჩივრებ	N;DAT;PL;INAN
საჩინო	საჩინო	ADJ;NOM;SG
საწყისი	საწყისის	ADJ;GEN;SG
საჭირო	საჭირო	ADJ;NOM;SG
სახავს	ისახავს	V;ARGOB3;ARGSU3S;ACT;PRS;IND;IPFV
სახალხო	სახალხო	ADJ;NOM;SG
სახე	სახეებს	N;DAT;PL;INAN
სახე	სახეს	N;DAT;INAN;SG
სახედარი	სახედრების	N;PL;GEN;ANIM
სახელმძღვანელო	სახელმძღვანელოს	N;GEN;INAN;SG
სახელმწიფო	სახელმწიფოს	N;GEN;INAN;SG
სახელმწიფო	სახელმწიფო	ADJ;GEN;SG
სახეობრივ-მეტაფორული	სახეობრივ-მეტაფორული	ADJ;NOM;SG
სახლი	სახლის	N;GEN;INAN;SG
სახლი	სახლ	N;DAT;INAN;SG
სახსარი	სახსრების	N;PL;GEN;INAN
საჯარო	საჯარო	ADJ;GEN;SG
სდევს	მოსდევდა	V;ARGOB3;ARGSU3S;FUT;ACT;PFV;IND
სერიოზული	სერიოზულ	ADJ;DAT;SG
სექტორი	სექტორის	N;GEN;INAN;SG
სიგრძე	სიგრძე	N;NOM;INAN;SG
სივრცე	სივრცეს	N;DAT;INAN;SG
სიზმარი	სიზმარ	N;DAT;INAN;SG
სილამაზე	სილამაზე	N;DAT;INAN;SG
სიმართლე	სიმართლის	N;GEN;INAN;SG
სიმაღლე	სიმაღლი	N;INS;INAN;SG
სიმსივნე	სიმსივნე	N;NOM;INAN;SG
სიმშვიდე	სიმშვიდეს	N;DAT;INAN;SG
სიმძაფრე	სიმძაფრე	N;NOM;INAN;SG
სინათლე	სინათლე	N;NOM;INAN;SG
სირიული	სირიულ	ADJ;DAT;SG
სისტემა	სისტემის	N;GEN;INAN;SG
სისხლი	სისხლის	N;GEN;INAN;SG
სიტუაცია	სიტუაცია	N;NOM;INAN;SG
სიტყვა	სიტყვები	N;PL;OM;INAN;N
სიტყვა	სიტყვით	N;INS;INAN;SG
სიტყვა	სიტყვებს	N;DAT;PL;INAN
სიტყვა	სიტყვა	N;NOM;INAN;SG
სიტყვაკაზმული	სიტყვაკაზმულ	ADJ;DAT;SG
სიტყვიერი	სიტყვიერი	ADJ;GEN;SG
სიღრმე	სიღრმე	N;DAT;INAN;SG
სიყვარული	სიყვარულითა	N;INS;INAN;SG
სიცილ-კისკისი	სიცილ-კისკისით	N;INS;INAN;SG
სიცოცხლე	სიცოცხლეს	N;DAT;INAN;SG
სიცოცხლე	სიცოცხლის	N;GEN;INAN;SG
სკოლა	სკოლის	N;GEN;INAN;SG
სოლიდარობა	სოლიდარობის	N;GEN;INAN;SG
სომხური	სომხურ	ADJ;DAT;SG
სოფელი	სოფლები	N;PL;OM;INAN;N
სოციალიზმი	სოციალიზმისა	N;GEN;INAN;SG
სოციალიზმი	სოციალიზმის	N;GEN;INAN;SG
სპეტაკი	სპეტაკი	ADJ;NOM;SG
სპეციალისტი	სპეციალისტების	N;PL;GEN;ANIM
სპეციალური	სპეციალურად	ADV
სპორტული	სპორტულ	ADJ;DAT;SG
სრული	სრულებითაც	ADJ;INS;PL
სრული	სრული	ADJ;GEN;SG
სრული	სრულ	ADJ;DAT;SG
სრულიად	სრულიად	ADV
სტადია	სტადია	N;NOM;INAN;SG
სტრატეგიული	სტრატეგიული	ADJ;GEN;SG
სტრუქტურა	სტრუქტურების	N;PL;GEN;INAN
სულ	სულ	ADV
სულაც	სულაც	ADV
სული	სული	N;NOM;INAN;SG
სული	სულმა	N;ERG;INAN;SG
სულიერება	სულიერებადა	N;FRML;INAN;SG
სულიერება	სულიერების	N;GEN;INAN;SG
სუნთქავს	ჩავისუნთქე	V;ARGOB3;ARGSU1S;PST;ACT;PFV;IND
სურათი	სურათი	N;NOM;INAN;SG
სურვილი	სურვილებ	N;DAT;PL;INAN
სუსტი	სუსტ	ADJ;DAT;SG
სწავლა	სწავლის	N;GEN;INAN;SG
სწავლება	სწავლების	N;GEN;INAN;SG
სწავლება	სწავლებისა	N;GEN;INAN;SG
სწამებს	სწამებენ	V;ARGIO3S;ARGOB3;ARGSU3P;ACT;PRS;IND;IPFV
სწორედ	სწორედ	ADV
სწორი	სწორი	ADJ;GEN;SG
სწრაფვა	სწრაფვამ	N;ERG;INAN;SG
სხვა	სხვა	N;PRO;OM;SG
სხვა	სხვათა	PRO;PL;DAT
სხივი	სხივები	N;PL;OM;INAN;N
სხივი	სხივებით	N;INS;PL;INAN
ტარდება	ჩატარდა	V;ARGSU3S;PST;ACT;PFV;IND
ტემპი	ტემპებ	N;DAT;PL;INAN
ტერიტორია	ტერიტორია	N;DAT;INAN;SG
ტერიტორიული	ტერიტორიული	ADJ;GEN;SG
ტესტი	ტესტი	N;NOM;INAN;SG
ტესტი	ტესტის	N;GEN;INAN;SG
ტესტი	ტესტს	N;DAT;INAN;SG
ტესტი	ტესტ	N;DAT;INAN;SG
ტექნიკა	ტექნიკით	N;INS;INAN;SG
ტექსტი	ტექსტების	N;PL;GEN;INAN
ტვირთი	ტვირთის	N;GEN;INAN;SG
ტიპური	ტიპური	ADJ;NOM;SG
ტკივილი	ტკივილის	N;GEN;INAN;SG
ტრანსპორტი	ტრანსპორტი	N;NOM;INAN;SG
ტრიმესტრი	ტრიმესტრის	N;GEN;INAN;SG
ტყუილი	ტყუილად	ADV
უ/მტკიცდება	დამტკიცებულიყო	V;ARGSU3S;ACT;PST+PRF;PFV;IND
უარყოფს	უარყოფდნენ	V;ARGOB3;ARGSU3P;IPFV;ACT;IND
უბრალო	უბრალოდ	ADV
უგდებს	მივუგდეთ	V;ARGIO3;ARGOB3;ARGSU1P;PST;ACT;PFV;IND
უდაო	უდაოდ	ADV
უდარდელობა	უდარდელობას	N;DAT;INAN;SG
უდგება	უდგებიან	V;ARGIO3;ARGSU3P;ACT;PRS;IND;IPFV
უეცრად	უეცრად	ADV
უზენაესობა	უზენაესობის	N;GEN;INAN;SG
უკანასკნელი	უკანასკნელი	ADJ;NOM;SG
უკვე	უკვე	ADV
უკმაყოფილება	უკმაყოფილებას	N;DAT;INAN;SG
უმოქმედობა	უმოქმედობა	N;NOM;INAN;SG
უნდა	უნდა	V;ARGOB3;ARGSU3S;PRS;IND
უნდა	მინდა	V;ARGOB3;ARGSU1S;PRS;IND
უნდა	მინდოდა	V;ARGOB3;ARGSU1S;IPFV;IND
უნივერსალური	უნივერსალურ	ADJ;GEN;SG
უნივერსიტეტი	უნივერსიტეტი	N;NOM;INAN;SG
უნივერსიტეტი	უნივერსიტეტ	N;DAT;INAN;SG
უნივერსიტეტი	უნივერსიტეტის	N;GEN;INAN;SG
უპირატესობა	უპირატესობას	N;DAT;INAN;SG
უპირველესი	უპირველეს	ADJ;GEN;SG
ურბის	გაურბოდნენ	V;ARGSU3P;ACT;IPFV;IND;IPFV
ურთიერთგაგება	ურთიერთგაგების	N;GEN;INAN;SG
ურთიერთობა	ურთიერთობა	N;NOM;INAN;SG
უსაფრთხოება	უსაფრთხოების	N;GEN;INAN;SG
უფლება	უფლება	N;NOM;INAN;SG
უფლება	უფლებათა	N;PL;GEN;INAN
უფლება	უფლებების	N;PL;GEN;INAN
უფლებადაცვითი	უფლებადაცვითი	ADJ;NOM;SG
უფრთხილდება	გავუფრთხილდე	V;ARGIO3;ARGSU1S;PST;ACT;PFV;IND
უფრო	უფრო	ADV
უფროსი	უფროსი	ADJ;NOM;SG
უფუნქციო	უფუნქციო	ADJ;GEN;SG
უქონელი	უქონელი	ADJ;GEN;SG
უყურებს	შეჰყურებდა	V;ARGOB3;ARGSU3S;FUT;ACT;PFV;IND
უცებ	უცებ	ADV
უძლებს	გაუძლოს	V;ARGIO3;ARGOB3;ARGSU3S;PST;ACT;PFV;IND
უძღვნის	მიუძღვის	V;ARGIO3;ARGOB3;ARGSU3S;FUT;ACT;PFV;IND
უწყინარი	უწყინარმა	ADJ;ERG;SG
ფანჯარა	ფანჯარა	N;DAT;INAN;SG
ფარგალი	ფარგლებს	N;DAT;PL;INAN
ფასეულობა	ფასეულობის	N;GEN;INAN;SG
ფაქტი	ფაქტს	N;DAT;INAN;SG
ფაქტი	ფაქტების	N;PL;GEN;INAN
ფერი	ფერის	N;GEN;INAN;SG
ფესვი	ფესვი	N;NOM;INAN;SG
ფეხქვეშ	ფეხქვეშ	ADV
ფინანსური	ფინანსური	ADJ;GEN;SG
ფიქრი	ფიქრი	N;NOM;INAN;SG
ფიქრი	ფიქრ	N;DAT;INAN;SG
ფიქრი	ფიქრთა	N;PL;GEN;INAN
ფიქრობს	იფიქროს	V;ARGOB3;ARGSU3S;PST;ACT;IND;IPFV
ფიქრობს	ფიქრობენ	V;ARGOB3;ARGSU3P;ACT;PRS;IND;IPFV
ფოთოლი	ფოთლები	N;PL;OM;INAN;N
ფონდი	ფონდების	N;PL;GEN;INAN
ფონი	ფონ	N;DAT;INAN;SG
ფორმა	ფორმები	N;PL;OM;INAN;N
ფორმატი	ფორმატების	N;PL;GEN;INAN
ფორმაცია	ფორმაციის	N;GEN;INAN;SG
ფორმაცია	ფორმაციისა	N;GEN;INAN;SG
ფორმაცია	ფორმაცია	N;NOM;INAN;SG
ფრაზეოლოგია	ფრაზეოლოგიას	N;DAT;INAN;SG
ფუნქციონირება	ფუნქციონირებით	N;INS;INAN;SG
ფშაველა	ფშაველა	N;SG;OM;PROPN
ქალაქი	ქალაქის	N;GEN;INAN;SG
ქალი	ქალი	N;NOM;ANIM;SG
ქალი	ქალმა	N;ERG;ANIM;SG
ქალი	ქალები	N;NOM;PL;ANIM
ქართველი	ქართველ	ADJ;DAT;SG
ქართველი	ქართველი	N;NOM;INAN;SG
ქართული	ქართული	ADJ;GEN;SG
ქართული	ქართულ	ADJ;DAT;SG
ქარი	ქარისა	N;GEN;INAN;SG
ქვემოთ	ქვემოთ	ADV
ქვეყანა	ქვეყნად	N;FRML;INAN;SG
ქვეყანა	ქვეყანას	N;DAT;INAN;SG
ქვეყანა	ქვეყანა	N;DAT;INAN;SG
ქვეყანა	ქვეყნის	N;GEN;INAN;SG
ქვეშ	ქვეშ	ADV
ქმნის	ქმნის	V;ARGOB3;ARGSU3S;ACT;PRS;IND;IPFV
ქმნის	ქმნიდნენ	V;ARGOB3;ARGSU3P;IPFV;ACT;IND;IPFV
ქულა	ქულებს	N;DAT;PL;INAN
ქულა	ქულა	N;NOM;INAN;SG
ღალატი	ღალატისა	N;GEN;INAN;SG
ღამე	ღამე	N;NOM;INAN;SG
ღებულობს	ღებულობს	V;ARGOB3;ARGSU3S;ACT;PRS;IND;IPFV
ღვინო	ღვინის	N;GEN;INAN;SG
ღვინო	ღვინოს	N;DAT;INAN;SG
ღირსეული	ღირსეული	ADJ;NOM;SG
ღირსშესანიშნაობა	ღირსშესანიშნაობას	N;DAT;INAN;SG
ღონისძიება	ღონისძიება	N;DAT;INAN;SG
ღრმა	ღრმად	ADV
ღრმა	ღრმა	ADJ;DAT;SG
ყვავილობა	ყვავილობა	N;NOM;INAN;SG
ყვანს	მიეყვანა	V;ARGOB3;ARGSU3S;ACT;PST+PRF;PFV;IND
ყვება	მიჰყვება	V;ARGIO1S;ARGSU3S;ACT;PRS;IND;IPFV
ყვება	მოჰყვა	V;ARGSU3S;PST;ACT;PFV;IND
ყველა	ყველას	PRO;DAT;SG
ყველა	ყველა	N;PRO;OM;SG
ყველაფერი	ყველაფერი	N;PRO;OM;SG
ყოველთვის	ყოველთვის	ADV
ყოველი	ყოველი	N;PRO;OM;SG
ყოველი	ყოვლისა	PRO;GEN;SG
ყოველი	ყოველ	PRO;GEN;SG
ყოველი	ყოველივე	PRO;NOM;SG
ყოფილი	ყოფილ	ADJ;DAT;SG
ყურადღება	ყურადღებას	N;DAT;INAN;SG
ყური	ყური	N;NOM;INAN;SG
შანდალი	შანდლებს	N;DAT;PL;INAN
შანიძე	შანიძე	N;SG;OM;PROPN
შანტაჟი	შანტაჟისა	N;GEN;INAN;SG
შარა	შარა	N;DAT;INAN;SG
შარაგზა	შარაგზას	N;DAT;INAN;SG
შარშან	შარშან	ADV
შეგრძნება	შეგრძნებისა	N;GEN;INAN;SG
შედარება	შედარებას	N;DAT;INAN;SG
შედარებითი	შედარებით	ADJ;FRML;SG
შედარებითი	შედარებითი	ADJ;NOM;SG
შედგენა	შედგენას	N;DAT;INAN;SG
შედეგი	შედეგად	N;FRML;INAN;SG
შედეგი	შედეგება	N;FRML;PL;INAN
შედეგი	შედეგები	N;PL;OM;INAN;N
შედეგი	შედეგების	N;PL;GEN;INAN
შეიცავს	შეიცავს	V;ARGOB3;ARGSU3S;FUT;ACT;PFV;IND
შეკავება-გაწონასწორება	შეკავება-გაწონასწორების	N;GEN;INAN;SG
შელახვა	შელახვას	N;DAT;INAN;SG
შემდგომი	შემდგომი	ADJ;NOM;SG
შემდგომი	შემდგომ	ADJ;DAT;SG
შემდეგ	შემდეგ	ADV
შემთხვევა	შემთხვევა	N;DAT;INAN;SG
შემთხვევა	შემთხვევებ	N;DAT;PL;INAN
შემოდგომა	შემოდგომით	N;INS;INAN;SG
შემოდის	შემოდიან	V;ARGSU3P;PRS;IND
შემომტანი	შემომტანი	ADJ;NOM;SG
შემოქმედება	შემოქმედების	N;GEN;INAN;SG
შემუშავება	შემუშავებას	N;DAT;INAN;SG
შემფასებელი	შემფასებლის	ADJ;GEN;SG
შემცველი	შემცველი	ADJ;NOM;SG
შენ	შენ	PRO;DAT;SG;2
შენ	შენს	PRO;DAT;SG;2
შესაბამისი	შესაბამისად	ADV
შესაბამისი	შესაბამისი	ADJ;NOM;SG
შესანიშნავი	შესანიშნავი	V;INS;FUT;V.PTCP;IND;SG
შესახებ	შესახებ	ADP;GEN
შესუსტება	შესუსტება	N;NOM;INAN;SG
შესწავლა	შესწავლას	N;DAT;INAN;SG
შესწავლილი	შესწავლილი	ADJ;NOM;SG
შეუძლია	შეიძლება	V;ARGSU3S;ACT;PRS;IND;IPFV
შეუძლია	შეიძლებოდა	V;ARGSU3S;PST;IND
შეფასება	შეფასება	N;NOM;INAN;SG
შეფასება	შეფასებასაც	N;DAT;INAN;SG
შეფასება	შეფასების	N;GEN;INAN;SG
შეფასება	შეფასებას	N;DAT;INAN;SG
შექმნილი	შექმნილი	ADJ;NOM;SG
შეშფოთება	შეშფოთებით	N;INS;INAN;SG
შეცვლა	შეცვლის	N;GEN;INAN;SG
შეხედვა	შეხედვით	N;INS;INAN;SG
შეხედულება	შეხედულება	N;NOM;INAN;SG
შვიდი	მეშვიდე	N;DAT;UM;SG
შთაგონება	შთაგონება	N;NOM;INAN;SG
ში	ში	DAT;ADP
შინაგანი	შინაგან	ADJ;DAT;SG
შორი	უშორესი	ADJ;INS;RL;SG
შორის	შორის	DAT;ADP
შრომითი	შრომითი	ADJ;GEN;SG
ჩანს	ჩანს	V;ARGSU3S;ACT;PRS;IND;IPFV
ჩართულობა	ჩართულობის	N;GEN;INAN;SG
ჩასატვირთ-გადმოსატვირთი	ჩასატვირთ-გადმოსატვირთი	ADJ;INS;SG
ჩემი	ჩემი	PRO;NOM;1;SG
ჩემი	ჩემს	PRO;DAT;1;SG
ჩემი	ჩემა	PRO;FRML;1;SG
ჩერდება	ჩერდება	V;ARGSU3S;ACT;PRS;IND;IPFV
ჩერდება	გაჩერდა	V;ARGSU3S;PST;ACT;PFV;IND
ჩერდება	შევჩერდით	V;ARGSU1P;PST;ACT;PFV;IND
ჩვენ	ჩვენა	PRO;FRML;1;PL
ჩვენ	ჩვენც	PRO;1;ERG;PL
ჩვენ	ჩვენს	PRO;DAT;1;PL
ჩვენ	ჩვენ	PRO;1;PL;GEN
ჩვენი	ჩვენმა	PRO;1;ERG;PL
ჩვენი	ჩვენი	PRO;NOM;1;PL
ჩვეულებრივი	ჩვეულებრივ	ADJ;DAT;SG
ჩვეულებრივი	ჩვეულებრივი	ADJ;GEN;SG
ჩიტაია	ჩიტაიამ	PRO;SG;ERG;PN
ჩიჩინი	ჩიჩინმა	N;ERG;INAN;SG
ჩნდება	გააჩნდა	V;ARGSU3S;PST;ACT;PFV;IND
ჩუმი	ჩუმად	ADV
ცა	ცას	N;DAT;INAN;SG
ცავს	მოიცავს	V;ARGOB3;ARGSU3S;FUT;ACT;PFV;IND
ცვივა	ცვივა	V;ARGOB3;ARGSU3S;PRS;IND
ცვლილება	ცვლილებაცა	N;NOM;INAN;SG
ცვლილება	ცვლილებების	N;PL;GEN;INAN
ცვლის	გამოიცვალა	V;ARGOB3;ARGSU3S;PST;ACT;PFV;IND
ცნობილი	ცნობილი	ADJ;NOM;SG
ცოდნა	ცოდნისა	N;GEN;INAN;SG
ცოდნა	ცოდნა	N;NOM;INAN;SG
ცოტა	ცოტა	N;NOM;UM;SG
ცოტაოდენი	ცოტაოდნად	ADJ;FRML;SG
ცულგადებული	ცულგადებული	ADJ;NOM;SG
ცქერს	დასცქერენ	V;ARGOB3;ARGSU3P;FUT;ACT;PFV;IND
ცხადი	ცხადი	ADJ;NOM;SG
ცხოველდება	გაცხოველდა	V;ARGSU3S;PST;ACT;PFV;IND
ცხოვრება	ცხოვრება	N;NOM;INAN;SG
ძალა	ძალა	N;NOM;INAN;SG
ძალა	ძალებით	N;INS;PL;INAN
ძალა	ძალების	N;PL;GEN;INAN
ძალა	ძალები	N;PL;OM;INAN;N
ძალადობა	ძალადობის	N;GEN;INAN;SG
ძალაუნებურად	ძალაუნებურად	ADV
ძველი	ძველი	ADJ;NOM;SG
ძველი	უძველეს	ADJ;DAT;RL;SG
ძვირფასი	ძვირფასი	ADJ;NOM;SG
ძვირფასი	ძვირფას	ADJ;DAT;SG
ძია	ძია	N;NOM;ANIM;SG
ძირეული	ძირეული	ADJ;GEN;SG
ძირითადად	ძირითადად	ADV
ძირითადი	ძირითადი	ADJ;NOM;SG
ძლიერი	ძლიერ	ADJ;DAT;SG
წაკითხული	წაკითხულის	ADJ;GEN;SG
წამება	წამებისა	N;GEN;INAN;SG
წარდგენა	წარდგენა	N;NOM;INAN;SG
წარმოებს	წარმოებს	V;ARGOB3;ARGSU3S;ACT;PRS;IND;IPFV
წარმოიდგინება	წარმოიდგინა	V;ARGSU3S;PST;ACT;PFV;IND
წარმომადგენელი	წარმომადგენელი	N;NOM;ANIM;SG
წარმომადგენელი	წარმომადგენლები	N;NOM;PL;ANIM
წარმომადგენელი	წარმომადგენელთა	N;PL;GEN;ANIM
წარმოუდგენელი	წარმოუდგენლად	ADJ;FRML;SG
წარსული	წარსულისა	N;GEN;INAN;SG
წარსული	წარსულის	N;GEN;INAN;SG
წევს	შესწევდა	V;ARGOB3;ARGSU3S;FUT;ACT;PFV;IND
წელი	წლითა	N;INS;INAN;SG
წელი	წლი	N;INS;INAN;SG
წელი	წლებ	N;DAT;PL;INAN
წელი	წლის	N;GEN;INAN;SG
წელიწადი	წელიწად	N;DAT;INAN;SG
წერილი	წერილი	N;NOM;INAN;SG
წერილობითი	წერილობითი	ADJ;NOM;SG
წერს	აღწერს	V;ARGIO3;ARGOB3;ARGSU3S;FUT;ACT;PFV;IND
წერს	წერენ	V;ARGIO3;ARGOB3;ARGSU3P;ACT;PRS;IND;IPFV
წერს	წერს	V;ARGIO3;ARGOB3;ARGSU3S;ACT;PRS;IND;IPFV
წესი	წესით	N;INS;INAN;SG
წესი	წესის	N;GEN;INAN;SG
წვლილი	წვლილი	N;NOM;INAN;SG
წიგნი	წიგნი	N;NOM;INAN;SG
წიგნი	წიგნის	N;GEN;INAN;SG
წილი	წილი	N;NOM;INAN;SG
წილი	წილ	N;DAT;INAN;SG
წინა	წინა	ADJ;DAT;SG
წინამძღოლი	წინამძღოლთა	N;PL;GEN;ANIM
წინანდალი	წინანდლისა	PRO;SG;GEN;PN
წინანდალი	წინანდალი	N;SG;OM;PROPN
წინასწარ	წინასწარ	ADV
წრე	წრეები	N;INS;PL;INAN
წუხელ	წუხელ	ADV
წყალი	წყალი	N;NOM;INAN;SG
წყარო	წყარო	N;NOM;INAN;SG
წყდება	გადაწყდეს	V;ARGSU3S;PST;ACT;PFV;IND
ჭავჭავაძე	ჭავჭავაძე	N;SG;OM;PROPN
ჭავჭავაძე	ჭავჭავაძის	PRO;SG;GEN;PN
ჭირდება	დამჭირდება	V;ARGIO1S;ARGSU3S;FUT;ACT;PFV;IND
ჭირდება	ჭირდებოდა	V;ARGSU3S;ACT;IPFV;IND;IPFV
ჭირისუფალი	ჭირისუფალ	N;DAT;ANIM;SG
ჭიქა	ჭიქა	N;NOM;INAN;SG
ჭრის	მჭრის	V;ARGOB1S;ARGSU3S;ACT;PRS;IND;IPFV
ჭყავის	ჭყავიან	V;ARGSU3P;ACT;PRS;IND;IPFV
ხაზი	ხაზ	N;DAT;INAN;SG
ხალხი	ხალხს	N;DAT;ANIM;SG
ხალხი	ხალხის	N;GEN;ANIM;SG
ხალხი	ხალხების	N;PL;GEN;ANIM
ხალხი	ხალხთა	N;PL;GEN;ANIM
ხალხი	ხალხებს	N;DAT;PL;ANIM
ხანი	ხანი	N;INS;INAN;SG
ხარვეზი	ხარვეზებსაც	N;DAT;PL;INAN
ხარისხი	ხარისხს	N;DAT;INAN;SG
ხარჯი	ხარჯების	N;PL;GEN;INAN
ხატოვანი	ხატოვნად	ADV
ხდება	გამხდარიყო	V;ARGSU3S;ACT;PST+PRF;PFV;IND
ხდება	ხდებოდა	V;ARGSU3S;ACT;IPFV;IND;IPFV
ხდება	ხდება	V;ARGSU3S;ACT;PRS;IND;IPFV
ხდება	გახდა	V;ARGSU3S;PST;ACT;PFV;IND
ხდის	ხდის	V;ARGOB3;ARGSU3S;ACT;PRS;IND;IPFV
ხედავს	დაინახა	V;ARGOB3;ARGSU2S;PST;ACT;IND
ხედავს	ვხედავთ	V;ARGOB3;ARGSU1P;ACT;PRS;IND
ხელი	ხელ	N;DAT;INAN;SG
ხელისუფლება	ხელისუფლებისა	N;GEN;INAN;SG
ხელისუფლება	ხელისუფლების	N;GEN;ANIM;SG
ხელისუფლება	ხელისუფლებას	N;DAT;ANIM;SG
ხელმეორე	ხელმეორედ	ADV
ხელმისაწვდომობა	ხელმისაწვდომობის	N;GEN;INAN;SG
ხელმძღვანელი	ხელმძღვანელი	N;NOM;ANIM;SG
ხელნაწერი	ხელნაწერი	N;NOM;INAN;SG
ხელნაწერი	ხელნაწერებს	N;DAT;PL;INAN
ხელოვნება	ხელოვნების	N;GEN;INAN;SG
ხელოვნება	ხელოვნება	N;DAT;INAN;SG
ხელფასი	ხელფასის	N;GEN;INAN;SG
ხელშემწყობი	ხელშემწყობი	ADJ;GEN;SG
ხერხი	ხერხები	N;PL;OM;INAN;N
ხვდება	ხვდებიან	V;ARGSU3P;ACT;PRS;IND;IPFV
ხვდება	გვხვდებოდა	V;ARGIO1P;ARGSU3S;FUT;ACT;IND;IPFV
ხიდი	ხიდის	N;GEN;INAN;SG
ხმა	ხმები	N;PL;OM;INAN;N
ხმაურა	ხმაური	N;NOM;INAN;SG
ხომ	ხომ	PART
ხუროთმოძღვრება	ხუროთმოძღვრება	N;NOM;INAN;SG
ხშირად	ხშირად	ADV
ჯარისკაცი	ჯარისკაცები	N;NOM;PL;ANIM
ჯერ	ჯერ	ADV
ჯეროვანი	ჯეროვანი	ADJ;GEN;SG
ჯერჯერობით	ჯერჯერობით	ADV
ჰარმონია	ჰარმონიას	N;DAT;INAN;SG
